01 01 01 01 01 01 01 01 01 01
01 00 00 00 00 00 00 00 01 01
01 00 A(00) 00 00 00 B(00) 00 00 01
01 00 00 00 02 02 00 00 00 01
01 00 00 00 02 P(00) 00 00 00 01
01 00 00 00 00 00 00 00 00 01
01 01 01 01 01 01 01 01 01 01
