01 01 01 01 01 01 01 01 01 01
01 00 00 00 00 00 00 00 00 01
01 00 A 00 00 00 00 00 00 01
01 00 00 00 02 02 00 00 00 01
01 02 00 00 02 00 00 00 00 01 01 01 02 02 02 02 02 01
01 02 03 00 00 00 P(00) 00 00 01 01 01 04 04 04 04 04 01
01 02 02 00 00 00 00 02 00 01 01 01 03 03 03 03 03 01
01 00 00 00 00 00 00 02 00 01 01 01 00 00 00 00 00 01
01 00 02 02 02 00 00 00 00 01 01 01 00 00 00 00 00 01
01 00 00 00 00 02 00 02 02 00 00 00 00 01 01 01 01 01
01 00 00 00 00 00 00 00 00 00 00 00 00 01
01 01 01 01 01 01 01 01 01 01 01 01 01 01
